111111
1P1  1
1C1  1
1E1  1
111111
